{
	"levels": [
		  { 
		  	"velocityIncrement" : 1,
		  	"brickLayout": [
		  		[0,0,0,0,0,0,0,0,0,0],
		  		[0,0,0,0,0,0,0,0,0,0],
		  		[0,0,0,0,0,0,0,0,0,0],
		  		[0,0,0,0,0,0,0,0,0,0],
		  		[0,0,0,0,0,0,0,0,0,0],
		  		[2,0,2,0,2,0,2,0,2,0]
		  	]
		  }, 
		  { 
		  	"velocityIncrement" : 2,
		  	"brickLayout": [
		  		[0,0,0,0,0,0,0,0,0,0],
		  		[0,0,0,0,0,0,0,0,0,0],
		  		[1,1,1,1,1,1,2,1,1,1],
		  		[2,0,1,0,2,0,1,0,1,0],
		  		[0,1,0,1,0,1,0,2,0,1],
		  		[1,0,1,0,1,0,1,0,1,0]
		  	]
		  }, 
		  {
		  	"velocityIncrement" : 3,
		  	"brickLayout": [
		  		[0,0,0,1,1,1,1,0,0,0],
		  		[0,1,1,1,1,1,1,1,0,0],
		  		[0,1,1,1,0,1,1,1,1,0],
		  		[1,2,0,1,0,1,0,1,1,1],
		  		[0,1,1,1,1,2,1,1,1,0],
		  		[0,0,0,1,1,1,1,0,0,0]
		  	]
		  },
		  {
		  	"velocityIncrement" : 4,
		  	"brickLayout": [
		  		[2,0,0,0,1,1,0,0,0,2],
		  		[0,0,0,0,1,2,0,0,0,0],
		  		[0,0,0,1,0,0,1,0,0,0],
		  		[0,0,1,0,0,0,0,1,0,0],
		  		[0,1,1,1,1,1,1,1,1,0],
		  		[1,0,0,0,0,0,0,0,0,1]
		  	]
		  },
		  {
		  	"velocityIncrement" : 5,
		  	"brickLayout": [
		  		[1,0,0,0,0,0,0,0,0,1],
		  		[0,1,0,0,2,2,0,0,1,0],
		  		[0,0,1,0,0,0,0,1,0,0],
		  		[0,2,0,1,0,0,1,0,0,0],
		  		[0,0,0,0,1,1,0,0,0,0],
		  		[2,2,0,0,1,1,0,0,2,2],
		  		[0,0,0,1,0,0,1,0,0,0],
		  		[0,0,1,0,0,0,0,1,0,0],
		  		[0,1,0,0,2,2,0,0,1,0],
		  		[1,0,0,0,0,0,0,0,0,1]
		  	]
		  },
		  { 
		  	"velocityIncrement" : 6,
		  	"brickLayout": [
		  		[1,0,1,0,1,0,1,0,1,0],
		  		[0,1,0,1,0,1,0,1,0,1],
		  		[1,0,1,0,1,0,2,0,1,0],
		  		[2,0,1,0,2,0,1,0,1,0],
		  		[0,1,0,1,0,1,0,2,0,1],
		  		[1,0,1,0,1,0,1,0,1,0]
		  	]
		  },
		  { 
		  	"velocityIncrement" : 7,
		  	"brickLayout": [
		  		[0,0,0,0,1,1,0,0,0,0],
		  		[0,0,0,2,1,1,1,0,0,0],
		  		[0,0,2,0,1,1,0,2,0,0],
		  		[0,1,0,0,1,1,0,0,1,0],
		  		[0,0,1,0,1,2,0,1,0,0],
		  		[0,0,0,2,1,1,1,0,0,0],
		  		[0,0,0,0,1,1,0,0,0,0]
		  	]
		  },
		  { 
		  	"velocityIncrement" : 8,
		  	"brickLayout": [
		  		[1,1,1,2,1,1,2,1,1,1],
		  		[1,1,1,1,1,1,1,1,1,1],
		  		[1,1,1,0,0,0,0,1,2,1],
		  		[1,2,1,0,0,0,0,1,1,1],
		  		[1,1,1,0,0,0,0,1,1,1],
		  		[1,1,1,1,1,1,1,2,1,1],
		  		[1,1,1,1,1,1,1,1,1,1]
		  	]
		  },
		  { 
		  	"velocityIncrement" : 9,
		  	"brickLayout": [
		  		[0,0,0,0,1,1,0,0,0,0],
		  		[0,0,0,0,1,1,0,0,0,0],
		  		[0,0,0,0,1,1,0,0,0,0],
		  		[1,1,1,1,1,1,1,2,1,1],
		  		[2,1,1,1,1,2,1,1,1,1],
		  		[0,0,0,0,1,1,0,0,0,0],
		  		[0,0,0,0,1,1,0,0,0,0],
		  		[0,0,0,0,1,1,0,0,0,0]
		  	]
		  },
		  { 
		  	"velocityIncrement" : 10,
		  	"brickLayout": [
		  		[1,1,0,0,0,0,0,1,1,1],
		  		[1,1,1,0,0,0,1,1,0,1],
		  		[1,0,0,1,1,1,1,0,0,1],
		  		[1,0,0,1,2,2,1,0,0,1],
		  		[1,1,1,1,1,1,1,1,1,1],
		  		[1,0,0,1,1,1,1,0,0,1],
		  		[1,0,1,1,0,0,1,0,0,1],
		  		[1,1,1,0,0,0,1,1,1,1]
		  	]
		  }
	]
}